PHRASAL VERBS
--> ***
    find out - learn, discover
    figure out - solve

    stumble
    
--> A
    add up - birbirini eklemek --> calculate
--> B
    break off - bitirmek, sonlandırmak --> terminate
--> C
    carry on - yapmaya devam etmek
    carry on - continue
    carry out - execute
    come up with - invent
    cut down - reduce
    catch up - meet
    call off - cancel
    call off - bir kişi veya hayvanın saldırmayı, kovalamayı kesmesini sağlamak
    count on - güvenmek --> trust
    come by - edinmek, elde etmek --> acquire
--> D
    come by - visit
    drop in - visit
    stop by - visit
    
--> E

--> F
    figure out - çözmek, düşünerek bulmak
    fall apart - kafa karışıklığı veya duygusal sebeplerle normal hayatını sürdürememek
    fed up - get frustrated


--> G
    go ahead - start
    get away - escape
    run away - escape
    get across - communicate
    get along with - iyi geçinmek
    
--> H
    hold on - wait

--> I
--> J
--> K
--> L
    look up to - saygı duymak --> respect
    look around - search
    look after - göz kulak olmak
    
--> M
--> N
--> O
--> P
    pass away - vefat etmek --> die
    point out - explain
    put up with - tolerate

--> R
    run into - rastlamak, karşılaşmak --> encounter

--> S
    stand for - temsil etmek --> represent
    see to - ilgilenmek, ayarlamak --> deal with, arrange
    set up - arrange

--> T
    take on - işe almak --> employ
    trust on - count on
    throw up - kusmak --> vomit
    turn down - reject
    touch on - mention

--> U
--> V
--> W
--> Y
--> Z


--> PHRASES IN A CAR
buckle up - kemerleri bağlamak
pull over - kenara çekmek, yol kenarında durmak
you cut me off - yolumu kestin -- cut off - birinin yolunu engellemek, önüne kırmak
back up - geri sürmek
slow down - hızı azaltmak, yavaşlamak






prepared by Uğur ARSLAN and His Students
