PHRASES
Every C in Pacific Ocean is pronounced differently
is that really so - gerçekten öyle mi
can you break a twenty - bir yirmilik bozabilir misin
I dont have any change on me - üzerimde hiç bozuk yok
we offer free delivery on orders over fifty dollar - elli dollar üzerindeki siparişlere ücretsiz kargo sunuyoruz
who will pay the diference - farkı kim ödeyecek?
get some rest - biraz dinlen
what is the hurry - ne bu acelen
your opinion will never cut me a check - senin fikrin benim kontrolümü kesemez
dont tempt me - beni kışkırtma
go ahead - hadi durma
I'm not everybody's cup of tea
James isnt a cat person. Dogs are his cup of tea
Bullets only do their jobs after they are fired


Are you going to marry him in the end - sonunda onunla evleniyor musun
we couldnt decide what to do in the end, we just stayed at home
I will see you at the end of the week - bu haftanın sonunda seni görürüm


IELTS English
you and I no longer engage in verbal confabulations   --> we dont talk anymore
in light of this evidence, it is crystal clear that.. --> in conclusion..
NY has a reputation of its dining establishments      --> NY has many restaurants
observe what course of action you compelled me to comit to --> look what you made me do



she wasn't told - ona söylenmedi
I was told to stay at home - evde kalmam söylendi
we were told not to leave the class - bize sınıftan dışarı çıkılmamamız söylendi

Baby month by Month - Infant Milestones
0-3   - holding head up
4-5   - rolling over both ways
5-7   - rising up on hands
6-8   - crawling
6-8   - sitting without support
9-10  - standing with support
11-15 - walking

fork - dört uçlu çatal
threek - üç uçlu çatal
twok - iki uçlu çatal
onek - tereyağı bıçağı
zerok - çay kaşığı

WAS / WERE GOING TO
i was going to call you but my battery died - seni arayacaktım ama şarjım bitti
i was going to leave it but i forgot - onu bırakacaktım ama unuttum
they were going to come to visit but - ziyaret etmeye geleceklerdi ama



ADJECTIVES
dodgy - unreliable, untrustworthy, dangerous
  this is really dodgy area and there are lots of dodgy people here
knackered - really very tired
  i really need to go to bed, I'm knackered
"the faker you are, the bigger your circle will be.
 the realer you are, the smaller your circle you are. These are well-known facts." R. Reynolds



PHRASAL VERBS
figure out - çözmek, düşünerek bulmak
carry on - yapmaya devam etmek
fall apart - kafa karışıklığı veya duygusal sebeplerle normal hayatını sürdürememek
call off - bir kişi veya hayvanın saldırmayı, kovalamayı kesmesini sağlamak
add up - birbirini eklemek
throw up - kusmak --> vomit
take on - işe almak --> employ
stand for - temsil etmek --> represent
count on - güvenmek --> trust
come by - edinmek, elde etmek --> acquire
break off - bitirmek, sonlandırmak --> terminate
look up to - saygı duymak --> respect
see to - ilgilenmek, ayarlamak --> deal with, arrange
run into - rastlamak, karşılaşmak --> encounter
pass away - ölmek --> die

buckle up - kemerleri bağlamak
pull over - kenara çekmek, yol kenarında durmak
you cut me off - yolumu kestin -- cut off - birinin yolunu engellemek, önüne kırmak
back up - geri sürmek
slow down - hızı azaltmak, yavaşlamak



1. I am in the hospital --> it means you are hospitalised
2. I am at the hospital --> it means you are visiting someone who has been hospitalised

this should not be done --> bu yapılmamalı
this should not have been done --> bu yapılmamalıydı

be concerned about - hakkında endişelenmek
be concerned with - ile ilgilenmek
concerns over - üzerine endişeler
a growing concern for - için artan endişe







