11) Konjunktionen (bağlaçlar)

# SUBORDINATING CONJ.
weil - because
damit - so that
wenn  - when(ever), if
bevor - before
ehe - before
falls - in case
seitdem - since then
dass - that
    -ich bin sehr froh, dass.. - I am very glad that..
so dass - so that
soweit - as far as
was - what
wohin - where to
wie viel - how much
ob - if, whether
obwohl - although
als ob - as if
als - when (past)
als wenn - as when
bis - until
indem - in which
sobald - as soon as
sooft - as often as
während - while
wo - where
wie - how
wie lange - how long
wie oft - how often
nachdem - after which
solange - as long as
soviel - as much as
warum - why
woher - where from
weshalb - why/for what reason
